20.ox
........o..o..oo....
..o.o.oo..ooo..o.o..
.....o...o.oo..o....
.o.o..oo...o.....o..
oo.......oo.o.oo....
o.oo.........o......
.....o....o..o....o.
..oo..o..o.....o....
o..o......o..o.o....
........o..o...o....
.....oo...o....o...o
o..o.....oooo....o..
......oo..........o.
.....o...o...ooo....
o........o.oo..o.o..
.o....o.........oo.o
o...oo......ooo..oo.
o.o.o...o...........
oo..........o.o.ooo.
o..o...o.........o..
